Aaron Jenner|Aaron Jenner
Abhijith Azhikkara|Abhijith Azhikkara
Abhishek Amin|Abhishek Amin
Abhishek Yadav|Abhishek Yadav
Adam Baldwin|Adam Baldwin
Adam Beer|Adam Beer
Adam Johannesson|Adam Johannesson
Addison Teague|Addison Teague
Adele Fletcher|Adele Fletcher
Adithya Kashyap|Adithya Kashyap
Adrian Parish|Adrian Parish
Aisling Hughes|Aisling Hughes
Akhil Visweswar|Akhil Visweswar
Alan Murphy|Alan Murphy
Alankit Thapa|Alankit Thapa
Alanna Suen|Alanna Suen
Alba Sanchez-Serrano|Alba Sanchez-Serrano
Aled Rhys Jones|Aled Rhys Jones
Alessandro Pieri|Alessandro Pieri
Alessandro Vastalegna|Alessandro Vastalegna
Alex Alvarez|Alex Alvarez
Alex Colthart|Alex Colthart
Alex Cox|Alex Cox
Alex Gruz|Alex Gruz
Alex James Macieira|Alex James Macieira
Alex Reinach|Alex Reinach
Alex Tolios-Zisos|Alex Tolios-Zisos
Alexandros Theodosiou|Alexandros Theodosiou
Alice Batten-Jacobs|Alice Batten-Jacobs
Alice Biddle|Alice Biddle
Alice Dinnean|Alice Dinnean
Alice Guillot|Alice Guillot
Alice Locuratolo|Alice Locuratolo
Alicia Aguilera|Alicia Aguilera
Alison McGowan|Alison McGowan
Alison Tisson|Alison Tisson
Alynne Schripsema|Alynne Schripsema
Amanda Bone|Amanda Bone
Amber Beattie|Amber Beattie
Amit Kumar Chahal|Amit Kumar Chahal
Amy Felton|Amy Felton
Amy Redfern|Amy Redfern
Amy Smith|Amy Smith
Amy Tapper|Amy Tapper
Analyn Cruz|Analyn Cruz
Anbarasu|Anbarasu
Andre Zweers|Andre Zweers
Andrea Detwiler|Andrea Detwiler
Andrea Hernandez|Andrea Hernandez
Andrea Walsh|Andrea Walsh
Andrei Austin|Andrei Austin
Andrew Burles|Andrew Burles
Andrew Morley|Andrew Morley
Andrew Spooner|Andrew Spooner
Andy Dickinson|Andy Dickinson
Andy Garner|Andy Garner
Andy Hargreaves|Andy Hargreaves
Andy Heath|Andy Heath
Andy Lowe|Andy Lowe
Andy Robb|Andy Robb
Aneel Ramanath|Aneel Ramanath
Angelica Placido|Angelica Placido
Angie Passmore|Angie Passmore
Angus Mitchell|Angus Mitchell
Ankush Gawande|Ankush Gawande
Ann Chow|Ann Chow
Anna Henderson|Anna Henderson
Anna McKindley|Anna McKindley
AnnapureddyBhaskerreddy|AnnapureddyBhaskerreddy
Annika Hellgren|Annika Hellgren
Annurup Kumaar|Annurup Kumaar
Anoop Tiwari|Anoop Tiwari
Anshul Kumar Srivastava|Anshul Kumar Srivastava
Anthony Bauyon|Anthony Bauyon
Anthony Mosley|Anthony Mosley
Apurv Swami|Apurv Swami
Arjun Pv|Arjun Pv
Arpit Soni|Arpit Soni
Artie Esposito|Artie Esposito
Arun Kumar|Arun Kumar
Arunvignesh|Arunvignesh
Ash Hawkins|Ash Hawkins
Ashar Alam|Ashar Alam
Ashley Mohabir|Ashley Mohabir
Asma Parvin|Asma Parvin
Aurora Shannon|Aurora Shannon
Balaji Lokesh|Balaji Lokesh
Balakrishnan Alagarsamy|Balakrishnan Alagarsamy
Balendu Kurup|Balendu Kurup
Barton Gilley|Barton Gilley
Becca Miller|Becca Miller
Becky Johnson|Becky Johnson
Benedict Minghella|Benedict Minghella
Bernard Esterhuysen|Bernard Esterhuysen
Bianca Appice|Bianca Appice
Bianca-Lee Burgess|Bianca-Lee Burgess
Bjorn Ole Schroeder|Bjorn Ole Schroeder
Boyan Georgiev|Boyan Georgiev
Brad Larner|Brad Larner
Bradley Elliott|Bradley Elliott
Brian Frank|Brian Frank
Brian Froud|Brian Froud
Brittan Brown|Brittan Brown
Byron O'Grady|Byron O'Grady
Callum Dixon|Callum Dixon
Calvin Vo|Calvin Vo
Candice White|Candice White
Carl Chadd|Carl Chadd
Carla Ramsey|Carla Ramsey
Carolina Grisorio|Carolina Grisorio
Carrie Perry|Carrie Perry
Casey Butler|Casey Butler
Catherine Fearon|Catherine Fearon
Cathy Shirk|Cathy Shirk
Cecily Fay|Cecily Fay
Celene McDowell|Celene McDowell
Celeste Talaszek|Celeste Talaszek
Charles Chorein|Charles Chorein
Charlie Bluett|Charlie Bluett
Chetan Vishwakarma|Chetan Vishwakarma
Chris Caldow|Chris Caldow
Chris Durfy|Chris Durfy
Chris Elson|Chris Elson
Chris Faczek|Chris Faczek
Chris Kendall|Chris Kendall
Chris Munns|Chris Munns
Chris Stones|Chris Stones
Chris Thatcher|Chris Thatcher
Christian Waite|Christian Waite
Christiane Barbknecht|Christiane Barbknecht
Christopher Antoniou|Christopher Antoniou
Christopher Jackson|Christopher Jackson
Christopher Lucas Maw|Christopher Lucas Maw
Christy Kail|Christy Kail
Clare Baybutt|Clare Baybutt
Clint Frift|Clint Frift
Colleen Jenkinson|Colleen Jenkinson
Colton Miller|Colton Miller
Connor Mills|Connor Mills
Cori Chan|Cori Chan
Craig Claassen|Craig Claassen
Craig Walters|Craig Walters
Cyrille Nomberg|Cyrille Nomberg
Daffy Hristova|Daffy Hristova
Daisy Beattie|Daisy Beattie
Damian Farrell|Damian Farrell
Dani Howard|Dani Howard
Daniel Ainslie|Daniel Ainslie
Daniel Cairnie|Daniel Cairnie
Daniel Moody|Daniel Moody
Daniel Pettipher|Daniel Pettipher
Daniel Stones|Daniel Stones
Danny Clark|Danny Clark
Danny Ryan|Danny Ryan
Darrell Briggs|Darrell Briggs
Dave Chapman|Dave Chapman
Dave Goetter|Dave Goetter
David Dunn|David Dunn
David Farmer|David Farmer
David Mackie|David Mackie
David Packard|David Packard
David Peifer|David Peifer
David Reinhold|David Reinhold
David Woods|David Woods
Dayne Millar|Dayne Millar
Dean Coldham|Dean Coldham
Debbie Watson|Debbie Watson
Deborah Phipps|Deborah Phipps
DeeJay Daljeet Singh|DeeJay Daljeet Singh
Deepakkumar Sharma|Deepakkumar Sharma
Demian Lovett|Demian Lovett
Derek Arnold|Derek Arnold
Dhananjayan|Dhananjayan
Diana Kim|Diana Kim
Diego González Cortés|Diego González Cortés
Dilpreet Kaur Walia|Dilpreet Kaur Walia
Dinesh Kumar Purushothaman|Dinesh Kumar Purushothaman
Dipen Majmundar|Dipen Majmundar
Dipu Rohan|Dipu Rohan
Dominic Aronin|Dominic Aronin
Dominic Meyrick-Brook|Dominic Meyrick-Brook
Doug Campbell|Doug Campbell
Doug Winningham|Doug Winningham
Drew Johnson|Drew Johnson
Drew Massey|Drew Massey
Duncan Riedl|Duncan Riedl
Dylan Ball|Dylan Ball
Dylan Vial|Dylan Vial
Ed Clark|Ed Clark
Edward Farmer|Edward Farmer
Eleanor Rogers|Eleanor Rogers
Elena Topouzoglou|Elena Topouzoglou
Elin Stone|Elin Stone
Elisabet Berggren|Elisabet Berggren
Elise Baker|Elise Baker
Elizabeth Mitchell|Elizabeth Mitchell
Elliot Best|Elliot Best
Elliot Coogan|Elliot Coogan
Elmar Bragi Einarsson|Elmar Bragi Einarsson
Emese Papp|Emese Papp
Emilia Harris|Emilia Harris
Emily Cruickshank|Emily Cruickshank
Emily Fiora Parks|Emily Fiora Parks
Emily Greeley|Emily Greeley
Emma Biggins|Emma Biggins
Emma Braney|Emma Braney
Emma Butt|Emma Butt
Emma Moffat|Emma Moffat
Emma Norton|Emma Norton
Emma Pilfold-Bagwell|Emma Pilfold-Bagwell
Eoin O'Sullivan|Eoin O'Sullivan
Esme Curtis|Esme Curtis
Eva Wagner|Eva Wagner
Eve Swayland|Eve Swayland
Farhad Mohasseb|Farhad Mohasseb
Faye Windridge|Faye Windridge
Federico Cervantes|Federico Cervantes
Finola McLennan|Finola McLennan
Fran Wright|Fran Wright
Frank Hanna|Frank Hanna
Fred Chapman|Fred Chapman
Fred Davis|Fred Davis
Gabriel Schucan|Gabriel Schucan
Ganesh Poojari|Ganesh Poojari
Gary Pawlowski|Gary Pawlowski
Genevieve McMahon|Genevieve McMahon
George Butler|George Butler
George Dupays|George Dupays
George Thomson|George Thomson
Georgia Somary|Georgia Somary
Georgina Cook|Georgina Cook
Gerard Moore|Gerard Moore
Glen Wiggall|Glen Wiggall
Gowtham Mahalingam|Gowtham Mahalingam
Grace Davison|Grace Davison
Grace Taylor|Grace Taylor
Greg Aronowitz|Greg Aronowitz
Greg Crawford|Greg Crawford
Greg Whitbrook|Greg Whitbrook
Haley Who|Haley Who
Harriet Dyson|Harriet Dyson
Harry Hamblin|Harry Hamblin
Harry Rylott|Harry Rylott
Hasan Balable|Hasan Balable
Hayley Dickinson|Hayley Dickinson
Hayley Garwood|Hayley Garwood
Heidi Elliott|Heidi Elliott
Helen Mullings|Helen Mullings
Hemanth Surana|Hemanth Surana
Hildegunn Meyer|Hildegunn Meyer
Holly Myer|Holly Myer
Howard Swindell|Howard Swindell
Howard Truong|Howard Truong
Hugh Purves|Hugh Purves
Hyson Pereira|Hyson Pereira
Ian Chase|Ian Chase
Ian Copeland|Ian Copeland
Iestyn Evans|Iestyn Evans
Immanuel Rajan|Immanuel Rajan
Jackie Mills|Jackie Mills
Jaeson Finn|Jaeson Finn
James Anthony|James Anthony
James Arnott|James Arnott
James Austin|James Austin
James Barham|James Barham
James Corless|James Corless
James Excell|James Excell
James Fitzpatrick|James Fitzpatrick
James Francis Sutherland Robson|James Francis Sutherland Robson
James Furlong|James Furlong
James Knowles|James Knowles
James Levett|James Levett
James Moxon|James Moxon
James Osborne|James Osborne
James Paul HattSmith|James Paul HattSmith
James Shirley|James Shirley
James Starr|James Starr
James Woodcock|James Woodcock
James Wright|James Wright
Jamie Briens|Jamie Briens
Jamie Hearing|Jamie Hearing
Jasmine Ford-Elgood|Jasmine Ford-Elgood
Jatin Bhavsar|Jatin Bhavsar
Javed Siddiqui|Javed Siddiqui
Javier Coronilla|Javier Coronilla
Jay Murray|Jay Murray
Jay Stevens|Jay Stevens
Jayaraj Muthukumar|Jayaraj Muthukumar
Jean-François Leroux|Jean-François Leroux
Jeremy Fernsler|Jeremy Fernsler
Jeremy Nocon|Jeremy Nocon
Jermaine Nix|Jermaine Nix
Jesse Jones|Jesse Jones
Jesse Turnbull|Jesse Turnbull
Jessica Currie|Jessica Currie
Jessica Emily Smith|Jessica Emily Smith
Jessica Scott-Reed|Jessica Scott-Reed
Jessica Tolan|Jessica Tolan
Jessie Hinton|Jessie Hinton
Joe Bannister|Joe Bannister
Joe Carhart|Joe Carhart
Joe Coffey|Joe Coffey
Joe Foster|Joe Foster
Joe Gidley|Joe Gidley
Joe Greco|Joe Greco
Joe Jackson|Joe Jackson
Joe Scott|Joe Scott
John Antill|John Antill
John Eaves|John Eaves
John Kay|John Kay
John Nolan|John Nolan
John O'Shaughnessy|John O'Shaughnessy
John Roesch|John Roesch
John Schoonraad|John Schoonraad
John Sorapure|John Sorapure
Johnny Roek|Johnny Roek
Jolan Auzeby|Jolan Auzeby
Jon Fenech|Jon Fenech
Jon Garwes|Jon Garwes
Jon McCoy|Jon McCoy
Jon Null|Jon Null
Jon Savage|Jon Savage
Jonas Ulrich|Jonas Ulrich
Jonathan Borland|Jonathan Borland
Jonathan Fransman|Jonathan Fransman
Jonathan Houston|Jonathan Houston
Jonathan Moore|Jonathan Moore
Jonathan Petts|Jonathan Petts
Jonathan Talbot|Jonathan Talbot
Jordan Dubash|Jordan Dubash
Jordan Watts|Jordan Watts
Jose Dinetto|Jose Dinetto
Jose Rebollo Redondo|Jose Rebollo Redondo
Josh Elwell|Josh Elwell
Josh Lowden|Josh Lowden
Joshi Umang|Joshi Umang
Joshua Callis-Smith|Joshua Callis-Smith
Joshua Morgan-Green|Joshua Morgan-Green
Joshua Polley|Joshua Polley
Juan Carlos Orihuela-Cuesta|Juan Carlos Orihuela-Cuesta
Judy Barr|Judy Barr
Julia Frost|Julia Frost
Justas Giedraitis|Justas Giedraitis
Kaitlyn Aylward|Kaitlyn Aylward
Kamesh Somalinga Sivarajan|Kamesh Somalinga Sivarajan
Kandace Morran|Kandace Morran
Karen Elliott|Karen Elliott
Karen Payne|Karen Payne
Karen Wand|Karen Wand
Karl Gallivan|Karl Gallivan
Karuppasamy Kumar|Karuppasamy Kumar
Kate Jeanne|Kate Jeanne
Kate Wilson|Kate Wilson
Katharina Benjamim|Katharina Benjamim
Katherine Smee|Katherine Smee
Katie Jordan|Katie Jordan
Kazia Roach|Kazia Roach
Kenn Hedin Kalvik|Kenn Hedin Kalvik
Kevin Antony|Kevin Antony
Kevin Baker|Kevin Baker
Kevin Day|Kevin Day
Kevin Harris|Kevin Harris
Kris Anderson|Kris Anderson
Kris Gropatsakis|Kris Gropatsakis
Kristin Catuogno|Kristin Catuogno
Kristin Dalleske|Kristin Dalleske
Kshirsagar Chaitanya|Kshirsagar Chaitanya
Lakshmanakumar|Lakshmanakumar
Lara Genovese|Lara Genovese
Laraib Atta|Laraib Atta
Laura Blount|Laura Blount
Laura Mountford|Laura Mountford
Laura Parkinson-Tuthill|Laura Parkinson-Tuthill
Laura Skinner|Laura Skinner
Lauren Perry|Lauren Perry
Lauren Sarah Davidson|Lauren Sarah Davidson
Laurence Moran|Laurence Moran
Laurence Priest|Laurence Priest
Lc Samuel|Lc Samuel
Lee Fobert|Lee Fobert
Lee Gilmore|Lee Gilmore
Lee Oliver|Lee Oliver
Leigh Stevens|Leigh Stevens
Leila Mousavi|Leila Mousavi
Lesa Gillespie|Lesa Gillespie
Lewis McCabe|Lewis McCabe
Lexi Young|Lexi Young
Liam Wright|Liam Wright
Lily Taylor|Lily Taylor
Lisa Davis|Lisa Davis
Lisa Turner|Lisa Turner
Lisa Wiik|Lisa Wiik
Liz Oliver|Liz Oliver
Lizzie Campbell-Kelly|Lizzie Campbell-Kelly
Lizzie Downes|Lizzie Downes
Lizzie Kelly|Lizzie Kelly
Lloyd Phillips|Lloyd Phillips
Lottie McDowell|Lottie McDowell
Lucy Pearce|Lucy Pearce
Lucy Thompson|Lucy Thompson
Lucy Wyborn|Lucy Wyborn
Lukasz Bukowiecki|Lukasz Bukowiecki
Luke Letkey|Luke Letkey
Luke Moorcock|Luke Moorcock
Lydia Mannering|Lydia Mannering
Lydia Wiltshire|Lydia Wiltshire
Lynn Robertson Bruce|Lynn Robertson Bruce
Maeve Callahan|Maeve Callahan
Mahajan Prashant|Mahajan Prashant
Mahalia John|Mahalia John
Maja Jensen|Maja Jensen
Makoto Koyama|Makoto Koyama
Marcus Clarke|Marcus Clarke
Mariana Vayanas|Mariana Vayanas
Marianne Huet|Marianne Huet
Martina Vazzoler|Martina Vazzoler
Martyn Hawkins|Martyn Hawkins
Marzun Patel|Marzun Patel
Matat Levin|Matat Levin
Matt Fisher|Matt Fisher
Matt Hovland|Matt Hovland
Matt Markham|Matt Markham
Matt Rowe|Matt Rowe
Matt Sedgewick|Matt Sedgewick
Matthew Lyons|Matthew Lyons
Matthew MacMurray|Matthew MacMurray
Matthew Tinsley|Matthew Tinsley
Mel Hayward|Mel Hayward
Melanie Byrne|Melanie Byrne
Mia Castles|Mia Castles
Mia Pearson|Mia Pearson
Micha Wabro|Micha Wabro
Michael Hennah|Michael Hennah
Michael James Robinson|Michael James Robinson
Michael Miller|Michael Miller
Michael Peters|Michael Peters
Michael Rhima|Michael Rhima
Michael Sinden|Michael Sinden
Michael Wacker|Michael Wacker
Michael Winsor|Michael Winsor
Michael Zannetou|Michael Zannetou
Michael Zhou|Michael Zhou
Michal Skowron|Michal Skowron
Mick Chubbock|Mick Chubbock
Mick Reid|Mick Reid
Mihai Stan|Mihai Stan
Mike Rhone|Mike Rhone
Mike Rotella|Mike Rotella
Mike Stillwell|Mike Stillwell
Mike Tehrani|Mike Tehrani
Mikey Brett|Mikey Brett
Milos Stojanovic|Milos Stojanovic
Minal Mistry|Minal Mistry
Mohan Ponraj|Mohan Ponraj
Mohit Varde|Mohit Varde
Monika Grochulska|Monika Grochulska
Moriah Etherington-Sparks|Moriah Etherington-Sparks
Mukund Agicha|Mukund Agicha
Muruganantham|Muruganantham
Myong Choi|Myong Choi
Nacho Gasco|Nacho Gasco
Nacho Thomas|Nacho Thomas
Nadarajan Usha Abheesh|Nadarajan Usha Abheesh
Naveen Babu Donga|Naveen Babu Donga
Neil Mulholland|Neil Mulholland
Neil Murrum|Neil Murrum
Nick Kool|Nick Kool
Nick Lawrence|Nick Lawrence
Nick Richardson|Nick Richardson
Nick Shaw|Nick Shaw
Nicky Belton|Nicky Belton
Nikhil Bhatnagar|Nikhil Bhatnagar
Niki Ryan|Niki Ryan
Nikki Pataracchia|Nikki Pataracchia
Nina Hartstone|Nina Hartstone
Nishant Subrahmanian|Nishant Subrahmanian
Noah Hamdan|Noah Hamdan
Norina Mackey|Norina Mackey
Oleksiy Golovchenko|Oleksiy Golovchenko
Oliver Blackaby|Oliver Blackaby
Oliver Dipre|Oliver Dipre
Oliver Johnstone|Oliver Johnstone
Olivia Palmarozza|Olivia Palmarozza
Olly Robinson|Olly Robinson
Oskars Vilnitis-Pantelejevs|Oskars Vilnitis-Pantelejevs
Owen Varley|Owen Varley
Oz Gani|Oz Gani
Pabbineedi Dileep|Pabbineedi Dileep
Paolo D'Arco|Paolo D'Arco
Parth Nikunj Joshi|Parth Nikunj Joshi
Pasquale Riefoli|Pasquale Riefoli
Patel Vikas|Patel Vikas
Patrick Barry|Patrick Barry
Patrick Johnson|Patrick Johnson
Patrik Krizovensky|Patrik Krizovensky
Paul Jones|Paul Jones
Paul McCullough|Paul McCullough
Paul McGuinness|Paul McGuinness
Paul Nelson|Paul Nelson
Paul Starkey|Paul Starkey
Paul Vincett|Paul Vincett
Paul Wolstencroft|Paul Wolstencroft
Pawel Polak|Pawel Polak
Pedro Fernandes Santos|Pedro Fernandes Santos
Peter Brooke|Peter Brooke
Peter Driscoll|Peter Driscoll
Peter Eszenyi|Peter Eszenyi
Peter Lee|Peter Lee
Peter Tindall|Peter Tindall
Phil Eason|Phil Eason
Phil Fletcher|Phil Fletcher
Phil Smith|Phil Smith
Philip Pendlebury|Philip Pendlebury
Philippa Broadhurst|Philippa Broadhurst
Prasad Vartak|Prasad Vartak
Prasad Wharavadekar|Prasad Wharavadekar
Pratheesh Chandran|Pratheesh Chandran
Praveen Thanvi|Praveen Thanvi
Prudhvi Krishna Machineni|Prudhvi Krishna Machineni
Quinn Robinson|Quinn Robinson
Rajeshree Patel|Rajeshree Patel
Ramchandra Birje|Ramchandra Birje
Ramisetty Krishna|Ramisetty Krishna
Randy Brown|Randy Brown
Ranjeet Kumar Singh|Ranjeet Kumar Singh
Ranvir Singh|Ranvir Singh
Raviraj Sawant|Raviraj Sawant
Reachmenobin|Reachmenobin
Rebekah Bukhbinder|Rebekah Bukhbinder
Reece Weldon|Reece Weldon
Regina Jiganti|Regina Jiganti
Resha Kambli|Resha Kambli
Reuben Montgomery|Reuben Montgomery
Rex Privratsky|Rex Privratsky
Rhiannon Willis|Rhiannon Willis
Robbie Chapman|Robbie Chapman
Rogelio Rodriguez|Rogelio Rodriguez
Roger Serrabassa Vilar|Roger Serrabassa Vilar
Roland Lukacsi|Roland Lukacsi
Ronan Murphy|Ronan Murphy
Rory Okey|Rory Okey
Rosalind Grégoire|Rosalind Grégoire
Rowena Vickerman|Rowena Vickerman
Roy Bell|Roy Bell
Russell Lukich|Russell Lukich
Ryan Morris|Ryan Morris
Ryan Purnell|Ryan Purnell
Sabiha Shaikh|Sabiha Shaikh
Sagar Ghadge|Sagar Ghadge
Salima Needham|Salima Needham
Salvatore Salamone|Salvatore Salamone
Sam Curtis|Sam Curtis
Sam Gunn|Sam Gunn
Sam Lane|Sam Lane
Sam Perez|Sam Perez
Sam Southwick|Sam Southwick
Samantha Kelm|Samantha Kelm
Sameera Bulusu|Sameera Bulusu
Sandra Murta|Sandra Murta
Sarah Burgess|Sarah Burgess
Sarah Collins|Sarah Collins
Sarah Mills|Sarah Mills
Sarah Skinner|Sarah Skinner
Sarah Williamson|Sarah Williamson
Sarath Sasidharan|Sarath Sasidharan
Sasha Camacho|Sasha Camacho
Sasha Jankovic|Sasha Jankovic
Sathishbabu|Sathishbabu
Saurabh Gavankar|Saurabh Gavankar
Sawan Thakrar|Sawan Thakrar
Sayani Mitra|Sayani Mitra
Scott Curtis|Scott Curtis
Sean Cooper|Sean Cooper
Sean Hixson|Sean Hixson
Sean Mathiesen|Sean Mathiesen
Sean Seymour|Sean Seymour
SenthilBalu|SenthilBalu
Shaik Javeed|Shaik Javeed
Shamim Seifzadeh|Shamim Seifzadeh
Shannon Moran|Shannon Moran
Shaunagh Edwards|Shaunagh Edwards
Shawna Zegarra|Shawna Zegarra
Sheila Clark|Sheila Clark
Shelley Roden|Shelley Roden
Sian Crisp|Sian Crisp
Sian Fenner|Sian Fenner
Siddharth Malviya|Siddharth Malviya
Simon Chiu|Simon Chiu
Simon Chubbock|Simon Chubbock
Simon Diggins|Simon Diggins
Simon Northcott|Simon Northcott
Simone Ceresato|Simone Ceresato
Singh Vinay|Singh Vinay
Sivaranjan|Sivaranjan
Siân Rees|Siân Rees
Sneha Saji|Sneha Saji
Sophie Dyer Bartlett|Sophie Dyer Bartlett
Sophie Shepherd|Sophie Shepherd
Sornalingam|Sornalingam
Stafford Lawrence|Stafford Lawrence
Stefan Drury|Stefan Drury
Stephan Pehrsson|Stephan Pehrsson
Stephen Bennett|Stephen Bennett
Stephen Delahunt|Stephen Delahunt
Stephen Swain|Stephen Swain
Steve Fitzpatrick|Steve Fitzpatrick
Steve James Brown|Steve James Brown
Steve Little|Steve Little
Steve Morris|Steve Morris
Steve Mosley|Steve Mosley
Steve Petrie|Steve Petrie
Steve Salmon|Steve Salmon
Steve Tizzard|Steve Tizzard
Stevee Davies|Stevee Davies
Steven Kaelin|Steven Kaelin
Steven Kynman|Steven Kynman
Steven Saunders|Steven Saunders
Stiv Schneider|Stiv Schneider
Stuart Walpole|Stuart Walpole
Sule Bryan|Sule Bryan
Sundar|Sundar
Surabhi Mundra|Surabhi Mundra
Susan Smith|Susan Smith
Swapnil Baravalia|Swapnil Baravalia
Tamsyn Manson|Tamsyn Manson
Tankodra Jaykishan|Tankodra Jaykishan
Taylor David|Taylor David
Thom Berryman|Thom Berryman
Thomas Kidd|Thomas Kidd
Thomas Lee|Thomas Lee
Thomas Lloyd|Thomas Lloyd
Thomas Markwick|Thomas Markwick
Tiggy Bough|Tiggy Bough
Tim Cherry-Jones|Tim Cherry-Jones
Tim Hands|Tim Hands
Tim Nielsen|Tim Nielsen
Tim O'Brien|Tim O'Brien
Tim Shotter|Tim Shotter
Tim Warner|Tim Warner
Timothy Preston|Timothy Preston
Tj Singh|Tj Singh
Toby Froud|Toby Froud
Toby Lloyd|Toby Lloyd
Tom Hocking|Tom Hocking
Tom Minor|Tom Minor
Tom Norman|Tom Norman
Tom Pegg|Tom Pegg
Travis Robinson|Travis Robinson
Trevor Jones|Trevor Jones
Tristan Nelson|Tristan Nelson
Tristan Warren|Tristan Warren
Trovy Simpson|Trovy Simpson
Ty Teiger|Ty Teiger
Uday Kumar Kongathi|Uday Kumar Kongathi
Umesh Ajayakumar|Umesh Ajayakumar
Valentina Visintin|Valentina Visintin
Vasco Cerqueira|Vasco Cerqueira
Venkat Vadisetti|Venkat Vadisetti
Venkateswara Rao Nama|Venkateswara Rao Nama
Vera Bennett|Vera Bennett
Vikki Medhurst|Vikki Medhurst
Vikram Prashanth|Vikram Prashanth
Vinayaga Sundar|Vinayaga Sundar
Vishal Dhagekar|Vishal Dhagekar
Vishal Kumar|Vishal Kumar
Vishnu Simha|Vishnu Simha
Vivien Wilson|Vivien Wilson
Warrick Brownlow-Pike|Warrick Brownlow-Pike
Wayne Lim|Wayne Lim
Wes Humphrey|Wes Humphrey
Wesley Vet|Wesley Vet
Whitney Hodack|Whitney Hodack
Will Gething|Will Gething
Will Wyatt|Will Wyatt
William Banyard|William Banyard
Wim Oppenheimer|Wim Oppenheimer
Xavier Matia Bernasconi|Xavier Matia Bernasconi
Xenia Moliner Roldan|Xenia Moliner Roldan
Yo-Naa Olofsson|Yo-Naa Olofsson
Yvonne Stone|Yvonne Stone
Zaheer Bijapure|Zaheer Bijapure
Zed|Zed
Zoe Liang|Zoe Liang