Aaron|Aaron
Abhijith|Abhijith
Abhishek|Abhishek
Adam|Adam
Addison|Addison
Adele|Adele
Adithya|Adithya
Adrian|Adrian
Aisling|Aisling
Akhil|Akhil
Alankit|Alankit
Alanna|Alanna
Alan|Alan
Alba|Alba
Aled|Aled
Alessandro|Alessandro
Alexandros|Alexandros
Alex|Alex
Alice|Alice
Alicia|Alicia
Alison|Alison
Alynne|Alynne
Amanda|Amanda
Amber|Amber
Amit|Amit
Amy|Amy
Analyn|Analyn
Anbarasu|Anbarasu
Andrea|Andrea
Andrei|Andrei
Andrew|Andrew
Andre|Andre
Andy|Andy
Aneel|Aneel
Angelica|Angelica
Angie|Angie
Angus|Angus
Ankush|Ankush
Annapureddy|Annapureddy
Anna|Anna
Annika|Annika
Annurup|Annurup
Ann|Ann
Anoop|Anoop
Anshul|Anshul
Anthony|Anthony
Apurv|Apurv
Arjun|Arjun
Arpit|Arpit
Artie|Artie
Arunvignesh|Arunvignesh
Arun|Arun
Ashar|Ashar
Ashley|Ashley
Ash|Ash
Asma|Asma
Aurora|Aurora
Balaji|Balaji
Balakrishnan|Balakrishnan
Balendu|Balendu
Barton|Barton
Becca|Becca
Becky|Becky
Benedict|Benedict
Bernard|Bernard
Bhaskerreddy|Bhaskerreddy
Bianca|Bianca
Bjorn|Bjorn
Boyan|Boyan
Bradley|Bradley
Brad|Brad
Brian|Brian
Brittan|Brittan
Byron|Byron
Callum|Callum
Calvin|Calvin
Candice|Candice
Carla|Carla
Carl|Carl
Carolina|Carolina
Carrie|Carrie
Casey|Casey
Catherine|Catherine
Cathy|Cathy
Cecily|Cecily
Celene|Celene
Celeste|Celeste
Charles|Charles
Charlie|Charlie
Chetan|Chetan
Christiane|Christiane
Christian|Christian
Christopher|Christopher
Christy|Christy
Chris|Chris
Clare|Clare
Clint|Clint
Colleen|Colleen
Colton|Colton
Connor|Connor
Cori|Cori
Craig|Craig
Cyrille|Cyrille
Daffy|Daffy
Daisy|Daisy
Damian|Damian
Daniel|Daniel
Dani|Dani
Danny|Danny
Darrell|Darrell
Dave|Dave
David|David
Dayne|Dayne
Dean|Dean
Debbie|Debbie
Deborah|Deborah
DeeJay|DeeJay
Deepakkumar|Deepakkumar
Demian|Demian
Derek|Derek
Dhananjayan|Dhananjayan
Diana|Diana
Diego|Diego
Dilpreet|Dilpreet
Dinesh|Dinesh
Dipen|Dipen
Dipu|Dipu
Dominic|Dominic
Doug|Doug
Drew|Drew
Duncan|Duncan
Dylan|Dylan
Edward|Edward
Ed|Ed
Eleanor|Eleanor
Elena|Elena
Elin|Elin
Elisabet|Elisabet
Elise|Elise
Elizabeth|Elizabeth
Elliot|Elliot
Elmar|Elmar
Emese|Emese
Emilia|Emilia
Emily|Emily
Emma|Emma
Eoin|Eoin
Esme|Esme
Eva|Eva
Eve|Eve
Farhad|Farhad
Faye|Faye
Federico|Federico
Finola|Finola
Frank|Frank
Fran|Fran
Fred|Fred
Gabriel|Gabriel
Ganesh|Ganesh
Gary|Gary
Genevieve|Genevieve
George|George
Georgia|Georgia
Georgina|Georgina
Gerard|Gerard
Glen|Glen
Gowtham|Gowtham
Grace|Grace
Greg|Greg
Haley|Haley
Harriet|Harriet
Harry|Harry
Hasan|Hasan
Hayley|Hayley
Heidi|Heidi
Helen|Helen
Hemanth|Hemanth
Hildegunn|Hildegunn
Holly|Holly
Howard|Howard
Hugh|Hugh
Hyson|Hyson
Ian|Ian
Iestyn|Iestyn
Immanuel|Immanuel
Jackie|Jackie
Jaeson|Jaeson
James|James
Jamie|Jamie
Jasmine|Jasmine
Jatin|Jatin
Javed|Javed
Javier|Javier
Jayaraj|Jayaraj
Jay|Jay
Jean|Jean
Jeremy|Jeremy
Jermaine|Jermaine
Jesse|Jesse
Jessica|Jessica
Jessie|Jessie
Joe|Joe
Johnny|Johnny
John|John
Jolan|Jolan
Jonas|Jonas
Jonathan|Jonathan
Jon|Jon
Jordan|Jordan
Jose|Jose
Joshi|Joshi
Joshua|Joshua
Josh|Josh
Juan|Juan
Judy|Judy
Julia|Julia
Justas|Justas
Kaitlyn|Kaitlyn
Kamesh|Kamesh
Kandace|Kandace
Karen|Karen
Karl|Karl
Karuppasamy|Karuppasamy
Kate|Kate
Katharina|Katharina
Katherine|Katherine
Katie|Katie
Kazia|Kazia
Kenn|Kenn
Kevin|Kevin
Kristin|Kristin
Kris|Kris
Kshirsagar|Kshirsagar
Lakshmanakumar|Lakshmanakumar
Laraib|Laraib
Lara|Lara
Laura|Laura
Laurence|Laurence
Lauren|Lauren
Lc|Lc
Lee|Lee
Leigh|Leigh
Leila|Leila
Lesa|Lesa
Lewis|Lewis
Lexi|Lexi
Liam|Liam
Lily|Lily
Lisa|Lisa
Lizzie|Lizzie
Liz|Liz
Lloyd|Lloyd
Lottie|Lottie
Lucy|Lucy
Lukasz|Lukasz
Luke|Luke
Lydia|Lydia
Lynn|Lynn
Maeve|Maeve
Mahajan|Mahajan
Mahalia|Mahalia
Maja|Maja
Makoto|Makoto
Marcus|Marcus
Mariana|Mariana
Marianne|Marianne
Martina|Martina
Martyn|Martyn
Marzun|Marzun
Matat|Matat
Matthew|Matthew
Matt|Matt
Melanie|Melanie
Mel|Mel
Mia|Mia
Michael|Michael
Michal|Michal
Micha|Micha
Mick|Mick
Mihai|Mihai
Mikey|Mikey
Mike|Mike
Milos|Milos
Minal|Minal
Mohan|Mohan
Mohit|Mohit
Monika|Monika
Moriah|Moriah
Mukund|Mukund
Muruganantham|Muruganantham
Myong|Myong
Nacho|Nacho
Nadarajan|Nadarajan
Naveen|Naveen
Neil|Neil
Nicky|Nicky
Nick|Nick
Nikhil|Nikhil
Niki|Niki
Nikki|Nikki
Nina|Nina
Nishant|Nishant
Noah|Noah
Norina|Norina
Oleksiy|Oleksiy
Oliver|Oliver
Olivia|Olivia
Olly|Olly
Oskars|Oskars
Owen|Owen
Oz|Oz
Pabbineedi|Pabbineedi
Paolo|Paolo
Parth|Parth
Pasquale|Pasquale
Patel|Patel
Patrick|Patrick
Patrik|Patrik
Paul|Paul
Pawel|Pawel
Pedro|Pedro
Peter|Peter
Philippa|Philippa
Philip|Philip
Phil|Phil
Prasad|Prasad
Pratheesh|Pratheesh
Praveen|Praveen
Prudhvi|Prudhvi
Quinn|Quinn
Rajeshree|Rajeshree
Ramchandra|Ramchandra
Ramisetty|Ramisetty
Randy|Randy
Ranjeet|Ranjeet
Ranvir|Ranvir
Raviraj|Raviraj
Reachmenobin|Reachmenobin
Rebekah|Rebekah
Reece|Reece
Regina|Regina
Resha|Resha
Reuben|Reuben
Rex|Rex
Rhiannon|Rhiannon
Robbie|Robbie
Rogelio|Rogelio
Roger|Roger
Roland|Roland
Ronan|Ronan
Rory|Rory
Rosalind|Rosalind
Rowena|Rowena
Roy|Roy
Russell|Russell
Ryan|Ryan
Sabiha|Sabiha
Sagar|Sagar
Salima|Salima
Salvatore|Salvatore
Samantha|Samantha
Sameera|Sameera
Sam|Sam
Sandra|Sandra
Sarah|Sarah
Sarath|Sarath
Sasha|Sasha
Sathishbabu|Sathishbabu
Saurabh|Saurabh
Sawan|Sawan
Sayani|Sayani
Scott|Scott
Sean|Sean
SenthilBalu|SenthilBalu
Shaik|Shaik
Shamim|Shamim
Shannon|Shannon
Shaunagh|Shaunagh
Shawna|Shawna
Sheila|Sheila
Shelley|Shelley
Sian|Sian
Siddharth|Siddharth
Simone|Simone
Simon|Simon
Singh|Singh
Sivaranjan|Sivaranjan
Siân|Siân
Sneha|Sneha
Sophie|Sophie
Sornalingam|Sornalingam
Stafford|Stafford
Stefan|Stefan
Stephan|Stephan
Stephen|Stephen
Stevee|Stevee
Steven|Steven
Steve|Steve
Stiv|Stiv
Stuart|Stuart
Sule|Sule
Sundar|Sundar
Surabhi|Surabhi
Susan|Susan
Swapnil|Swapnil
Tamsyn|Tamsyn
Tankodra|Tankodra
Taylor|Taylor
Thomas|Thomas
Thom|Thom
Tiggy|Tiggy
Timothy|Timothy
Tim|Tim
Tj|Tj
Toby|Toby
Tom|Tom
Travis|Travis
Trevor|Trevor
Tristan|Tristan
Trovy|Trovy
Ty|Ty
Uday|Uday
Umesh|Umesh
Valentina|Valentina
Vasco|Vasco
Venkateswara|Venkateswara
Venkat|Venkat
Vera|Vera
Vikki|Vikki
Vikram|Vikram
Vinayaga|Vinayaga
Vishal|Vishal
Vishnu|Vishnu
Vivien|Vivien
Warrick|Warrick
Wayne|Wayne
Wesley|Wesley
Wes|Wes
Whitney|Whitney
William|William
Will|Will
Wim|Wim
Xavier|Xavier
Xenia|Xenia
Yo|Yo
Yvonne|Yvonne
Zaheer|Zaheer
Zed|Zed
Zoe|Zoe